*Gramatyka*

Nazwy krajów zawsze piszemy wielką literą, a przymiotniki określające język małą:

Konstrukcja mówić po ...-u:

Znam (język)...    Mówię po...

francuski  - po francusku
hiszpański - po hiszpańsku
angielski  - po angielsku
polski     - po polsku
włoski     - po włosku
niemiecki  - po niemiecku
szwedzki   - po szwedzku
ukraiński  - po ukraińsku


Koniugacja (-m, -sz)
l.poj           l.mn.
ja  mieszkam    my  mieszkamy
ty  mieszkasz   wy  mieszkacie
on              oni
ona mieszka     one mieszkają
ono


Koniugacja (-ę, -isz)
l.poj           l.mn.
ja  pochodzę z      my  pochodzimy z
ty  pochodzisz z    wy  pochodzicie z
on              oni
ona pochodzi z  one pochodzą z
ono

Wskazywanie

*Słownictwo*

Nazwy krajów - Назви країн:
Anglia - Англія
Francja - Франція
Grecja - Греція
Hiszpania - Іспанія
Irlandia - Ірландія
Litwa - Литва
Niemcy - Німеччина
Norwegia - Норвегія
Polska - Польща
Portugalia - Португалія
Słowacja - Словаччина
Szkocja - Шотландія
Szwajcaria - Швейцарія
Szwecja - Швеція
Turcja - Туреччина
Ukraina - Україна
Włochy - Італія


Stolice - Столиці:
Ankara - Анкара
Ateny - Афіни
Berlin - Берлін
Berno - Берн
Bratysława - Братислава
Kijów - Київ
Lizbona - Лісабон
Londyn - Лондон
Madryt - Мадрид
Paryż - Париж
Rzym - Рим
Sztokholm - Стокгольм
Warszawa - Варшава
Wilno - Вільнюс


Kolory - Кольори:
Biały - Білий
Czarny - Чорний
Czerwony - Червоний
Fioletowy - Фіолетовий
Niebieski - Синій
Pomarańczowy - Помаранчевий
Zielony - Зелений
Żółty - Жовтий


Wskazywanie położenia względem - Вказівка ​​на відносне положення:
na lewo od - зліва від
na prawo od - праворуч від
po lewej - зліва
po prawej - праворуч
poniżej - нижче
powyżej - вище
u dołu - на дні
u góry - на вершині
na południe od/południu - на південь від/ південь
na północ od/północy - на північ від/ північ
na wschód od/wschodzie - на схід від/ схід
na zachód od/zachodzie - на захід від / захід


Kierunki geograficzne - Географічні напрямки:
południe - південь
południowy wschód - південний схід
południowy zachód - південний захід
północ - північ
północny wschód - північний схід
północny zachód - північний захід
wschód - cхід
zachód - Західний


Pochodzenie - Походження:
leżeć - брехати
mieszkać - жити
pochodzić - походять
znajdować się - бути


Inne - Інший:
ciekawostka - цікавість
lubić - подібно до
przyjaciel - друг